
          ###                                  
         #####                                 
         #####                                 
          # #                                  
 ########## ##########                          
 #                   #                          
 #     ############  #                          
 #     #          #  #                          
 # ### #   ###    #  #                     
 # #####   #####  #  #                     
 # #L#     #L# #  #  #                     
 #  #       #  #  #  #
 #  #########  #  #  #                     
 #      #      #  #  #                     
 #      #      #  #  #                     
 #      #   #######  #                     
 #     ### ###       #                       
 #     #x# ###       #                       
 ######### ###########
 #                   #                         
 #                   #                         
 #           ###     #                         
 #   ##      #########                         
 ######      ##      #                         
 #   ##########      #                         
 #       #           #                         
 #       #           #                         
 #       #           #                         
 #       ### ### ### #                         
 #         # # # # # # 
 #         ### ### ###                         
 #                   #                         
 #                   #                         
 ################### #                         
                   # #                         
                   # #                         
                   # #                         
                   # #                         
                   # #                         
                   # #                         
                   # #                         
                   # #                         
                   # #                         
                   # #                         
                   # #                         
                   # #                         
                   # #                         
                   # #                         
                   # #                         
                   # #                         
                   # #                         
                   # #                         
                   # #                         
                   # #                         
                   # #                         
                   ######                      
                   ######                      
