   >---^--    ^-<
   |  t-----v-b |
   |          | |
   |    -v-   | |
   |     |    | |
   |     | r--l |
   |            |
   >---     ----<
   |            |
   |            |
   |            |
